SIN : 싱가폴 - 싱가폴
ICN : 인천 - 한국
HNL : 호놀룰루 - 미국
HKT : 푸켓 - 태국
MXP : 밀란 말펜사 - 이탈리아
ANC : 앵커리지 - 미국
DFW : 댈러스 포트워스 - 미국
NRT : 나리타 - 일본
HND : 하네다 - 일본
GMP : 김포 - 한국
KIX : 오사카 간사이 - 일본
NGO : 나고야 - 일본
FUK : 후쿠오카 - 일본
OKA : 오키나와 - 일본
CTS : 삿포로 신 치토세 - 일본
LAX : 로스앤젤레스 - 미국
SFO : 샌프란시스코 - 미국
JFK : 존F 케네디 - 미국
SEA : 시애틀 타코마 - 미국
ATL : 애틀랜타 - 미국
DLC : 대련 - 중국
CGQ : 창춘 - 중국
TAO : 칭다오 신 - 중국
TFU : 사천 청두 - 중국
TSN : 톈진 - 중국
PEK : 베이징 서우두 - 중국
HRB : 하얼빈 타이핑 - 중국
XIY : 시안 시엔양 - 중국
NKG : 난징 루커우 - 중국
YNJ : 옌지 차오양촨 - 중국
HGH : 항저우 샤오산 - 중국
PVG : 상하이 푸동 - 중국
SHA : 상하이 홍차오 - 중국
SZX : 심천(선전) - 중국
HAN : 하노이 - 베트남
SGN : 호치민 떤선녓 - 베트남
CDG : 파리 샤를드골 - 프랑스
BCN : 바르셀로나 - 스페인
LHR : 런던 - 영국
FRA : 프랑크푸르트 - 독일
IST : 이스탄불 - 튀르키예
FCO : 피우미치노 - 로마
UBN : 울란바토르 칭키즈 칸 - 몽골
TAS : 타슈켄트 - 우즈벡
ALA : 알마티 - 카자흐스탄
BRU : 브뤼셀 - 벨기에